       NO textures/alice.png


SO textures/yunchia.png



WE textures/lempi.png
EA textures/miyuki.png

C 204,225,255
F 225,204,255

1111111111111111111a
1000000000000000001
1000000000000000001
1000000000000000001
100000000S000000001
1000000000000000001
1000000000000000001
1000000000000000001
1111111111111111111
