       NO textures/alice.png


SO textures/yunchia.png



WE textures/lempi.png
EA textures/miyuki.png

C 0,225,255
F 99,78,255



11111111111 1111111
1000000000000000001
1000000000000000001
1000000000000000001
100000000E000000001
1000000000000000001
1000000000000000001
1000000000000000001
1111111111111111111
