       NO textures/alice.png


SO textures/yunchia.png



WE textures/lempi.png
EA textures/miyuki.png

C 204,225,255
F 219,202,255




1111111111111111111
1001001001001000001
1011000001000001001
1001001001111101111
1001111000S1001001
10000000011100001001
1001111111111001001
1111000000000001011
1000000001000000001
1111111111111111111
