       NO textures/alice.png


SO textures/yunchia.png



WE textures/lempi.png
EA textures/miyuki.png

C 204,225,255
F 219,2,255


1111111111111111111
1011001001001000101
1111000001000001011
10010010011111S1111
1010000001000000101
1010000001000000101
1010000001000000101
1010000001000000101
1000000000000000001
1000000000000000001
1000000000000000001
1000000000000000001
1000000000000000001
1000000000000000001
1000000000000000001
1000000000000000001
1000000000000000001
1000000000000000001
1000000000000000001
1000000000000000001
1000000000000000001
1000000000000000001
1000000000000000001
1000000000000000001
1010000001000000101
1000000000000000001
1000000000000000001
1000000000000000001
1000000000000000001
1000000000000000001
1000000000000000001
1000000000000000001
1000000000000000001
1000000000000000001
1000000000000000001
1000000000000000001
1000000000000000001
1000000000000000001
1000000000000000001
1000000000000000001
1000000000000000001
1010000001000000101
1000000000000000001
1000000000000000001
1000000000000000001
1000000000000000001
1000000000000000001
1000000000000000001
1000000000000000001
1000000000000000001
1000000000000000001
1000000000000000001
1000000000000000001
1000000000000000001
1000000000000000001
1000000000000000001
1000000000000000001
1000000000000000001
1010000001000000101
1000000000000000001
1000000000000000001
1000000000000000001
1000000000000000001
1000000000000000001
1000000000000000001
1000000000000000001
1000000000000000001
1000000000000000001
1000000000000000001
1000000000000000001
1000000000000000001
1000000000000000001
1000000000000000001
1000000000000000001
1000000000000000001
1010000001000000101
1000000000000000001
1000000000000000001
1000000000000000001
1000000000000000001
1000000000000000001
1000000000000000001
1000000000000000001
1000000000000000001
1000000000000000001
1000000000000000001
1000000000000000001
1000000000000000001
1000000000000000001
1000000000000000001
1000000000000000001
1000000000000000001
1010000001000000101
1000000000000000001
1000000000000000001
1000000000000000001
1000000000000000001
1000000000000000001
1000000000000000001
1000000000000000001
1000000000000000001
1000000000000000001
1000000000000000001
1000000000000000001
1000000000000000001
1000000000000000001
1000000000000000001
1000000000000000001
1000000000000000001
1010000001000000101
1000000000000000001
1000000000000000001
1000000000000000001
1000000000000000001
1000000000000000001
1000000000000000001
1000000000000000001
1000000000000000001
1000000000000000001
1000000000000000001
1000000000000000001
1000000000000000001
1000000000000000001
1000000000000000001
1000000000000000001
1000000000000000001
1010000001000000101
1000000000000000001
1000000000000000001
1000000000000000001
1000000000000000001
1000000000000000001
1000000000000000001
1000000000000000001
1000000000000000001
1000000000000000001
1000000000000000001
1000000000000000001
1000000000000000001
1000000000000000001
1000000000000000001
1000000000000000001
1000000000000000001
1010000001000000101
1000000000000000001
1000000000000000001
1000000000000000001
1000000000000000001
1000000000000000001
1000000000000000001
1000000000000000001
1000000000000000001
1000000000000000001
1000000000000000001
1000000000000000001
1000000000000000001
1000000000000000001
1000000000000000001
1000000000000000001
1000000000000000001
1010000001000000101
1000000000000000001
1000000000000000001
1000000000000000001
1000000000000000001
1000000000000000001
1000000000000000001
1000000000000000001
1000000000000000001
1000000000000000001
1000000000000000001
1000000000000000001
1000000000000000001
1000000000000000001
1000000000000000001
1000000000000000001
1000000000000000001
1010000001000000101
1000000000000000001
1000000000000000001
1000000000000000001
1000000000000000001
1000000000000000001
1000000000000000001
1000000000000000001
1000000000000000001
1000000000000000001
1000000000000000001
1000000000000000001
1000000000000000001
1000000000000000001
1000000000000000001
1000000000000000001
1000000000000000001
1010000001000000101
1000000000000000001
1000000000000000001
1000000000000000001
1000000000000000001
1000000000000000001
1000000000000000001
1000000000000000001
1000000000000000001
1000000000000000001
1000000000000000001
1000000000000000001
1000000000000000001
1000000000000000001
1000000000000000001
1000000000000000001
1000000000000000001
1010000001000000101
1000000000000000001
1000000000000000001
1000000000000000001
1000000000000000001
1000000000000000001
1000000000000000001
1000000000000000001
1000000000000000001
1000000000000000001
1000000000000000001
1000000000000000001
1000000000000000001
1000000000000000001
1000000000000000001
1000000000000000001
1000000000000000001
1010000001000000101
1000000000000000001
1000000000000000001
1000000000000000001
1000000000000000001
1000000000000000001
1000000000000000001
1000000000000000001
1000000000000000001
1000000000000000001
1000000000000000001
1000000000000000001
1000000000000000001
1000000000000000001
1000000000000000001
1000000000000000001
1000000000000000001
1010000001000000101
1000000000000000001
1000000000000000001
1000000000000000001
1000000000000000001
1000000000000000001
1000000000000000001
1000000000000000001
1000000000000000001
1000000000000000001
1000000000000000001
1000000000000000001
1000000000000000001
1000000000000000001
1000000000000000001
1000000000000000001
1000000000000000001
1010000001000000101
1000000000000000001
1000000000000000001
1000000000000000001
1000000000000000001
1000000000000000001
1000000000000000001
1000000000000000001
1000000000000000001
1000000000000000001
1000000000000000001
1000000000000000001
1000000000000000001
1000000000000000001
1000000000000000001
1000000000000000001
1000000000000000001
1010000001000000101
1000000000000000001
1000000000000000001
1000000000000000001
1000000000000000001
1000000000000000001
1000000000000000001
1000000000000000001
1000000000000000001
1000000000000000001
1000000000000000001
1000000000000000001
1000000000000000001
1000000000000000001
1000000000000000001
1000000000000000001
1000000000000000001
1010000001000000101
1000000000000000001
1000000000000000001
1000000000000000001
1000000000000000001
1000000000000000001
1000000000000000001
1000000000000000001
1000000000000000001
1000000000000000001
1000000000000000001
1000000000000000001
1000000000000000001
1000000000000000001
1000000000000000001
1000000000000000001
1000000000000000001
1010000001000000101
1000000000000000001
1000000000000000001
1000000000000000001
1000000000000000001
1000000000000000001
1000000000000000001
1000000000000000001
1000000000000000001
1000000000000000001
1000000000000000001
1000000000000000001
1000000000000000001
1000000000000000001
1000000000000000001
1000000000000000001
1000000000000000001
1010000001000000101
1000000000000000001
1000000000000000001
1000000000000000001
1000000000000000001
1000000000000000001
1000000000000000001
1000000000000000001
1000000000000000001
1000000000000000001
1000000000000000001
1000000000000000001
1000000000000000001
1000000000000000001
1000000000000000001
1000000000000000001
1000000000000000001
1010000001000000101
1000000000000000001
1000000000000000001
1000000000000000001
1000000000000000001
1000000000000000001
1000000000000000001
1000000000000000001
1000000000000000001
1000000000000000001
1000000000000000001
1000000000000000001
1000000000000000001
1000000000000000001
1000000000000000001
1000000000000000001
1000000000000000001
1010000001000000101
1000000000000000001
1000000000000000001
1000000000000000001
1000000000000000001
1000000000000000001
1000000000000000001
1000000000000000001
1000000000000000001
1000000000000000001
1000000000000000001
1000000000000000001
1000000000000000001
1000000000000000001
1000000000000000001
1000000000000000001
1000000000000000001
1010000001000000101
1000000000000000001
1000000000000000001
1000000000000000001
1000000000000000001
1000000000000000001
1000000000000000001
1000000000000000001
1000000000000000001
1000000000000000001
1000000000000000001
1000000000000000001
1000000000000000001
1000000000000000001
1000000000000000001
1000000000000000001
1000000000000000001
1010000001000000101
1000000000000000001
1000000000000000001
1000000000000000001
1000000000000000001
1000000000000000001
1000000000000000001
1000000000000000001
1000000000000000001
1000000000000000001
1000000000000000001
1000000000000000001
1000000000000000001
1000000000000000001
1000000000000000001
1000000000000000001
1000000000000000001
1000000000000000001
1000000000000000001
1000000000000000001
1000000000000000001
1000000000000000001
1000000000000000001
1000000000000000001
1000000000000000001
1000000000000000001
1000000000000000001
1000000000000000001
1000000000000000001
1000000000000000001
1000000001110000101
1111111111111111111
