WE textures/lempi.png
NO textures/alice.png
SO textures/yunchia.png
F 17,38,64
EA textures/snowprincess.png
C 218,234,235


        111111111111111111111111111
        100000000011100000000000001
        10110000011 110000000000001
        100100000001000000N0000111
111111111011000001110000000000001
100000000011000001110111110111111
11110111111111011100000010001
11110111111111011101010010001
11000000110101011100000010001
10000000000000001100000010001
1000000000M0000001101010010001
1100000111010101111101111000111
11110111 10110101 11111010001
11111111 1111111 111111111111
