NO textures/alice.png
SO textures/yunchia.png
WE textures/lempi.png
EA textures/miyuki.png

F 20,20,20
C 200,200,200

        111111111111111111111111111
        100000000011100000000000001
        10110000011110000000000001
        1001000000010000000000011
1111111E1011000001110000000000001
100000000011000001110111110111111
11110111111111011100000010001
11111111111111111101010010001
11000000110101011100000010001
10000000000000001100000010001
100000000010000001101010010001
1100000111010101111101111000111
1111011110110101111110100011
111111111111111111111111111

