       NO textures/alice.png


SO textures/yunchia.png



WE textures/lempi.png
EA textures/snowprincess.png

F 20,20,200
C 200,200,20


1111E
11111
10101
10001
10001
10001
11011
10011
10011
10011
10011
10011
11111
