NO textures/test1.png



		SO         textures/test2.png


WE textures/test3.png
EA textures/test4.png

C 204,225,255
F 225,204,255

1111111111111111111
1111111111111111111
