NO textures/alice.png


SO textures/yunchia.png



WE textures/lempi.png
EA textures/snowprincess.png

F 20,20,20
C 200,200,200

1111111111111111111
1111111111111111111
