NO textures/alice.png


SO textures/yunchia.png

WE textures/lempi.png
EA textures/miyuki.png

C 204,225,255
F 255,255,255

        11111111111111111111111111
        100000000011100000000000001
        10110000011110000000000001
        100100000001000000N000011
111111111011000001110000000000001
100000000011000001110111110111111
11110111111111011100000010001
11110111111111011101010010001
11000000110101011100000010001
10000000000000001100000010001
1000000000E0000001101010010001
1100000111010101111101111000111
111101111011010111111010001
111111111111111111111111111
